rows 33
cols 33
players 2

m .................................
m .................................
m ...a.........................b...
m ..a...........................b..
m .................................
m .................................
m .................................
m ..............$.$.$..............
m .................................
m .................................
m ..............$...$..............
m .................................
m .................................
m ............$.......$............
m .................................
m .................................
m ...........$.........$...........
m .................................
m .................................
m ...........$.........$...........
m .................................
m .................................
m ............$.......$............
m .................................
m .................................
m ...........$.........$...........
m .................................
m .................................
m ...........$.........$...........
m .................................
m ................$................
m .............$.....$.............
m .................................
