rows 31
cols 37
players 2
actions_per_turn 10

m .....................................
m ...............$.....$...............
m .....................................
m ..............$.......$..............
m ..................$..................
m .....................................
m .........$.................$.........
m ..................$..................
m .....................................
m ..........$...............$..........
m .....$............$............$.....
m .............$.........$.............
m .....................................
m .....................................
m ..............$.......$..............
m .....................................
m .....................................
m ...............$.....$...............
m .....................................
m .....................................
m .....................................
m .....................................
m .....................................
m .....................................
m .....................................
m .....................................
m .a.................................b.
m ..a...............................b..
m ...a.............................b...
m ....a...........................b....
m .....................................
