rows 28
cols 33
players 2
maxpoints 1

m .................................
m .................................
m .................................
m .................................
m .................................
m .................................
m .................................
m .................................
m .................................
m .................................
m .................................
m .................................
m .................................
m .................................
m ................$................
m .................................
m .................................
m .................................
m .................................
m .................................
m .................................
m .................................
m .................................
m .................................
m .................................
m .................................
m ....a.......................b....
m .................................
