rows 33
cols 41
players 2

m .........................................
m .$..................$..................$.
m ...............$.........$...............
m .........................................
m ....................$....................
m .........................................
m .........................................
m ....................$....................
m .........................................
m .........................................
m ....................$....................
m .........................................
m .........................................
m ....................$....................
m .........................................
m .........................................
m .......b.b.b.b......$......a.a.a.a.......
m .........................................
m .........................................
m ....................$....................
m .........................................
m .........................................
m ....................$....................
m .........................................
m .........................................
m ....................$....................
m .........................................
m .........................................
m ....................$....................
m .........................................
m ...............$.........$...............
m .$..................$..................$.
m .........................................
