rows 25
cols 33
players 2

m .................................
m .a.............................b.
m .................................
m ................$................
m ...........$.........$...........
m .................................
m ........$......$.$......$........
m ...........$.........$...........
m .......$......$...$......$.......
m .................................
m .................................
m ..............$...$..............
m .................................
m .............$.....$.............
m .................................
m ..............$...$..............
m .................................
m .................................
m .................................
m .................................
m .................................
m .a.............................b.
m ..a...........................b..
m ...a.........................b...
m .................................
