rows 28
cols 33
players 2

m .................................
m ...a........a......b........b....
m ..a..........................b...
m .a............................b..
m .................................
m .................................
m .................................
m .................................
m .................................
m .................................
m .................................
m .................................
m .................................
m ................$................
m .............$.....$.............
m .................................
m ............$.......$............
m .................................
m ...........$.........$...........
m ........$...............$........
m ...........$.........$...........
m ........$...............$........
m ...........$.........$...........
m .................................
m ..............$...$..............
m .................................
m ..............$...$..............
m .................................
